############
#OOOOOOOOOO#
#S######O###
#O#OOOOOOOO#
#O#O######O#
#O#O#OOOOOO#
#OOO##O#O###
#O#OOOO#O###
#O##O#OOOOO#
#O#OO#####O#
#OOO##OOOGO#
############