###OOO##
#OOO#O##
#O###O##
OOOO#G##
O####O##
O##OOO##
O##O####
SOOO####