###OOOOO##O##
#OOO##O###O##
#O####OOOOO##
OOOO######GOO
O###########O
O##OOO#OOO#OO
O##O#O#O#O#O#
SOOO#OOO#OOO#